............vvv.
____.......>EEE<
__S_.......>EEE<
____......>~o_~<
__vv.....>____<#
.__o_...>____<#.
.____..>~^^~<#..
.__vv___o__<#...
>>__o_____<#....
>>_______<#.....
.>>~~~~~<#......
...^^^^^#.......
...#####........
@4@Sharper angle@